(supertux-level
  (version 2)
  (name (_ "Challenges Ahead"))
  (author "R. Bassett Jr.")
  (contact "www.tpot.ca")
  (license "non-redistributable")
  (sector
    (name "main")
    (music "music/rg-story-02.ogg")
    (init-script "	Effect.fade_in(6);
	Camera.set_mode(\"manual\");
	Tux.deactivate();
	capt.set_action(\"stand-right\");
	dora.set_action(\"stand-right\");
	Text.set_anchor_point(ANCHOR_MIDDLE);
	Text.set_pos(-50, -250);
	Text.set_text(\"         A Hero's Welcome\\n\\nNever before had Neillia, Baylea, and Abby\\nfelt so wonderful. Looking into the faces\\nof those they saved, they were on top of\\nthe world. But the Captain of the S.S. Bonjour\\nwarned them of great challenges ahead.\\n\\nWord was that Nolok had their mother captive\\nin his beach house, while their father's location\\nwas unkown and Tux's health remained a\\nmystery...\");
	wait(6);
	Text.fade_in(5);
	wait(24);
	Text.fade_out(5);
	wait(4);
	// End the level
	Effect.fade_out(2);
	wait(2);
	Level.finish(true);	
")
    (ambient-light 1 1 1)
    (background
      (speed 0.5)
      (image "images/background/robsky_seamless.jpg")
    )
    (camera
      (mode "normal")
    )
    (candle
      (x 576)
      (y 480)
    )
    (candle
      (x 10)
      (y 462.5783)
    )
    (scriptedobject
      (name "capt")
      (visible #t)
      (physic-enabled #f)
      (solid #f)
      (x 320)
      (y 480)
      (sprite "images/creatures/penguins/male-hook.sprite")
    )
    (scriptedobject
      (name "toopy")
      (visible #t)
      (physic-enabled #f)
      (solid #f)
      (x 717.0294)
      (y 447.3604)
      (sprite "images/creatures/penguins/male-2.sprite")
    )
    (scriptedobject
      (name "dora")
      (visible #t)
      (physic-enabled #f)
      (solid #f)
      (x 626.006)
      (y 446.3812)
      (sprite "images/creatures/penguins/female-hiker.sprite")
    )
    (scriptedobject
      (name "ariel")
      (visible #t)
      (physic-enabled #f)
      (solid #f)
      (x 501.006)
      (y 447.3812)
      (sprite "images/creatures/penguins/female-ariel.sprite")
    )
    (scriptedobject
      (name "captcandy")
      (visible #t)
      (physic-enabled #f)
      (solid #f)
      (x 61.00598)
      (y 722.6506)
      (sprite "images/creatures/penguins/male-hiker-hat.sprite")
    )
    (spawnpoint
      (name "main")
      (x 256)
      (y 480)
    )
    (tilemap
      (solid #t)
      (z-pos 0)
      (name "Interactive")
      (width 50)
      (height 35)
      (tiles
      28 28 28 28 28 28 28 28 28 28 28 28 28 28 28 28 28 28 28 28 28 28 28 28 28 28 28 28 28 28 28 28 28 28 28 28 28 28 28 28 28 28 28 28 28 28 28 28 28 28
      28 28 28 28 28 28 28 28 28 28 28 28 28 28 28 28 28 28 28 28 28 28 28 28 28 28 28 28 28 28 28 28 28 28 28 28 28 28 28 28 28 28 28 28 28 28 28 28 28 28
      28 28 28 28 28 28 28 28 28 28 28 28 28 28 28 28 28 28 28 28 28 28 28 28 28 28 28 28 28 28 28 28 28 28 28 28 28 28 28 28 28 28 28 28 28 28 28 28 28 28
      28 28 28 28 28 28 28 28 28 28 28 28 28 28 28 28 28 28 28 28 28 28 28 28 28 28 28 28 28 28 28 28 28 28 28 28 28 28 28 28 28 28 28 28 28 28 28 28 28 28
      28 28 28 28 28 28 28 28 28 28 28 28 28 28 28 28 28 28 28 28 28 28 28 28 28 28 28 28 28 28 28 28 28 28 28 28 28 28 28 28 28 28 28 28 28 28 28 28 28 28
      28 28 28 28 28 28 28 28 28 28 28 28 28 28 28 28 28 28 28 28 28 28 28 28 28 28 28 28 28 28 28 28 28 28 28 28 28 28 28 28 28 28 28 28 28 28 28 28 28 28
      0 0 0 0 0 0 0 0 0 0 0 0 0 0 0 0 0 0 0 0 0 0 0 0 0 0 0 0 0 0 0 0 0 0 0 0 0 0 0 0 0 0 0 0 0 0 0 0 0 0
      0 0 0 0 0 0 0 0 0 0 0 0 0 0 0 0 0 0 0 0 0 0 0 0 0 0 0 0 0 0 0 0 0 0 0 0 0 0 0 0 0 0 0 0 0 0 0 0 0 0
      0 0 0 0 0 0 0 0 0 0 0 0 0 0 0 0 0 0 0 0 0 0 0 0 0 0 0 0 0 0 0 0 0 0 0 0 0 0 0 0 0 0 0 0 0 0 0 0 0 0
      0 0 0 0 0 0 0 0 0 0 0 0 0 0 0 0 0 0 0 0 0 0 0 0 0 0 0 0 0 0 0 0 0 0 0 0 0 0 0 0 0 0 0 0 0 0 0 0 0 0
      0 0 27 28 28 29 0 0 0 0 0 0 27 28 28 29 0 0 0 0 0 0 27 28 28 29 0 0 0 0 0 27 28 28 29 0 0 0 0 0 0 27 28 28 29 0 0 0 0 0
      0 211 0 0 0 0 211 0 0 0 0 211 0 0 0 0 211 0 0 0 0 211 0 0 0 0 211 0 0 0 211 0 0 0 0 211 0 0 0 0 211 0 0 0 0 211 0 0 0 0
      0 212 0 0 0 0 212 0 2655 2656 0 212 0 0 0 0 212 0 2655 2656 0 212 0 0 0 0 212 0 2655 2656 212 0 0 0 0 212 0 2655 2656 0 212 0 0 0 0 212 0 2655 2656 0
      0 212 0 0 0 0 212 0 2659 2660 0 212 0 0 0 0 212 0 2659 2660 0 212 0 0 0 0 212 0 2659 2660 212 0 0 0 0 212 0 2659 2660 0 212 0 0 0 0 212 0 2659 2660 0
      0 213 0 0 0 0 213 0 0 0 0 213 0 0 0 0 213 0 0 0 0 213 0 0 0 0 213 0 0 0 213 0 0 0 0 213 0 0 0 0 213 0 0 0 0 213 0 0 0 0
      1633 1634 27 28 28 29 0 0 0 0 0 0 27 28 28 29 0 0 0 0 0 0 27 28 28 29 0 0 0 0 0 27 28 28 29 0 0 0 0 0 0 27 28 28 29 0 0 0 0 0
      1640 1641 1642 0 0 0 0 0 0 0 0 0 0 0 0 0 0 2155 2164 2157 0 0 0 0 2155 2164 2157 0 0 0 0 0 0 0 0 0 0 0 0 0 0 0 0 0 0 0 0 0 0 0
      1644 1645 1649 0 0 0 0 0 0 0 0 0 0 0 0 0 1545 0 2162 0 1545 0 0 1545 0 2162 0 1545 0 0 0 0 0 0 0 0 0 0 0 0 0 0 0 0 0 0 0 0 0 0
      28 28 28 28 28 28 28 28 28 28 28 28 28 28 29 27 28 28 28 28 29 27 28 28 28 28 28 28 28 28 0 0 0 0 0 0 0 0 0 0 0 0 0 0 0 0 0 0 0 0
      0 0 0 0 2807 0 0 0 2811 0 0 2811 0 212 27 28 29 0 0 0 0 0 0 0 0 0 0 0 0 0 0 0 0 0 0 0 0 0 0 0 0 0 0 0 0 0 0 0 0 0
      0 0 0 0 2809 0 0 0 77 0 0 2807 0 212 0 27 28 29 0 0 0 0 0 0 0 0 0 0 0 0 0 0 0 0 0 0 0 0 0 0 0 0 0 0 0 0 0 0 0 0
      0 0 0 0 2811 0 0 0 0 0 0 2809 0 212 0 0 27 28 29 0 0 0 0 0 0 0 0 0 0 0 0 0 0 0 0 0 0 0 0 0 0 0 0 0 0 0 0 0 0 0
      0 0 0 0 77 0 0 0 0 0 0 2811 0 212 0 0 0 27 28 29 0 0 0 0 0 0 0 0 0 0 0 0 0 0 0 0 0 0 0 0 0 0 0 0 0 0 0 0 0 0
      0 0 0 0 0 0 0 0 0 0 0 2807 0 212 0 2047 0 0 27 28 29 0 0 0 0 0 0 0 0 0 0 0 0 0 0 0 0 0 0 0 0 0 0 0 0 0 0 0 0 0
      77 77 0 0 0 0 0 0 0 0 0 2809 0 212 0 2048 0 0 0 27 28 29 0 0 0 0 0 0 0 0 0 0 0 0 0 0 0 0 0 0 0 0 0 0 0 0 0 0 0 0
      77 77 77 77 0 0 0 0 0 0 0 2811 0 213 0 2048 0 0 0 0 27 28 29 0 0 0 0 0 0 0 0 0 0 0 0 0 0 0 0 0 0 0 0 0 0 0 0 0 0 0
      77 77 77 77 77 77 0 0 0 0 0 2807 0 0 0 2048 0 0 0 0 0 27 28 29 0 0 0 0 0 0 0 0 0 0 0 0 0 0 0 0 0 0 0 0 0 0 0 0 0 0
      77 77 77 77 77 77 77 0 0 0 0 77 0 0 0 2048 0 0 0 0 0 0 27 28 29 0 0 0 0 0 0 0 0 0 0 0 0 0 0 0 0 0 0 0 0 0 0 0 0 0
      77 77 77 77 77 77 77 0 0 0 0 0 0 0 0 2049 0 0 0 0 0 0 0 27 28 29 0 0 0 0 0 0 0 0 0 0 0 0 0 0 0 0 0 0 0 0 0 0 0 0
      28 28 28 28 28 28 28 28 28 28 28 28 28 28 28 28 28 28 28 28 28 28 28 28 28 28 28 28 28 28 28 28 28 28 28 28 28 28 28 28 28 28 28 28 28 28 28 28 28 28
      28 28 28 28 28 28 28 28 28 28 28 28 28 28 28 28 28 28 28 28 28 28 28 28 28 28 28 28 28 28 28 28 28 28 28 28 28 28 28 28 28 28 28 28 28 28 28 28 28 28
      28 28 28 28 28 28 28 28 28 28 28 28 28 28 28 28 28 28 28 28 28 28 28 28 28 28 28 28 28 28 28 28 28 28 28 28 28 28 28 28 28 28 28 28 28 28 28 28 28 28
      28 28 28 28 28 28 28 28 28 28 28 28 28 28 28 28 28 28 28 28 28 28 28 28 28 28 28 28 28 28 28 28 28 28 28 28 28 28 28 28 28 28 28 28 28 28 28 28 28 28
      28 28 28 28 28 28 28 28 28 28 28 28 28 28 28 28 28 28 28 28 28 28 28 28 28 28 28 28 28 28 28 28 28 28 28 28 28 28 28 28 28 28 28 28 28 28 28 28 28 28
      28 28 28 28 28 28 28 28 28 28 28 28 28 28 28 28 28 28 28 28 28 28 28 28 28 28 28 28 28 28 28 28 28 28 28 28 28 28 28 28 28 28 28 28 28 28 28 28 28 28
      )
    )
    (tilemap
      (solid #f)
      (z-pos -100)
      (name "Back")
      (width 50)
      (height 35)
      (tiles
      3732 3732 3732 3732 3732 3732 3732 3732 3732 3732 3732 3732 3732 3732 3732 3732 3732 3732 3732 3732 3732 3732 3732 3732 3732 3732 3732 3732 3732 3732 3732 3732 3732 3732 3732 3732 3732 3732 3732 3732 3732 3732 3732 3732 3732 3732 3732 3732 3732 3732
      3732 3732 3732 3732 3732 3732 3732 3732 3732 3732 3732 3732 3732 3732 3732 3732 3732 3732 3732 3732 3732 3732 3732 3732 3732 3732 3732 3732 3732 3732 3732 3732 3732 3732 3732 3732 3732 3732 3732 3732 3732 3732 3732 3732 3732 3732 3732 3732 3732 3732
      3732 3732 3732 3732 3732 3732 3732 3732 3732 3732 3732 3732 3732 3732 3732 3732 3732 3732 3732 3732 3732 3732 3732 3732 3732 3732 3732 3732 3732 3732 3732 3732 3732 3732 3732 3732 3732 3732 3732 3732 3732 3732 3732 3732 3732 3732 3732 3732 3732 3732
      3732 3732 3732 3732 3732 3732 3732 3732 3732 3732 3732 3732 3732 3732 3732 3732 3732 3732 3732 3732 3732 3732 3732 3732 3732 3732 3732 3732 3732 3732 3732 3732 3732 3732 3732 3732 3732 3732 3732 3732 3732 3732 3732 3732 3732 3732 3732 3732 3732 3732
      3732 3732 3732 3732 3732 3732 3732 3732 3732 3732 3732 3732 3732 3732 3732 3732 3732 3732 3732 3732 3732 3732 3732 3732 3732 3732 3732 3732 3732 3732 3732 3732 3732 3732 3732 3732 3732 3732 3732 3732 3732 3732 3732 3732 3732 3732 3732 3732 3732 3732
      3732 3732 3732 3732 3732 3732 3732 3732 3732 3732 3732 3732 3732 3732 3732 3732 3732 3732 3732 3732 3732 3732 3732 3732 3732 3732 3732 3732 3732 3732 3732 3732 3732 3732 3732 3732 3732 3732 3732 3732 3732 3732 3732 3732 3732 3732 3732 3732 3732 3732
      3732 3732 3732 3732 3732 3732 3732 3732 3732 3732 3732 3732 3732 3732 3732 3732 3732 3732 3732 3732 3732 3732 3732 3732 3732 3732 3732 3732 3732 3732 3732 3732 3732 3732 3732 3732 3732 3732 3732 3732 3732 3732 3732 3732 3732 3732 3732 3732 3732 3732
      3732 3732 3732 3732 3732 3732 3732 3732 3732 3732 3732 3732 3732 3732 3732 3732 3732 3732 3732 3732 3732 3732 3732 3732 3732 3732 3732 3732 3732 3732 3732 3732 3732 3732 3732 3732 3732 3732 3732 3732 3732 3732 3732 3732 3732 3732 3732 3732 3732 3732
      3732 3732 3732 3732 3732 3732 3732 3732 3732 3732 3732 3732 3732 3732 3732 3732 3732 3732 3732 3732 3732 3732 3732 3732 3732 3732 3732 3732 3732 3732 3732 3732 3732 3732 3732 3732 3732 3732 3732 3732 3732 3732 3732 3732 3732 3732 3732 3732 3732 3732
      3732 3732 3732 3732 3732 3732 3732 3732 3732 3732 3732 3732 3732 3732 3732 3732 3732 3732 3732 3732 3732 3732 3732 3732 3732 3732 3732 3732 3732 3732 3732 3732 3732 3732 3732 3732 3732 3732 3732 3732 3732 3732 3732 3732 3732 3732 3732 3732 3732 3732
      3732 3732 3732 3732 3732 3732 3732 3732 3732 3732 3732 3732 3732 3732 3732 3732 3732 3732 3732 3732 3732 3732 3732 3732 3732 3732 3732 3732 3732 3732 3732 3732 3732 3732 3732 3732 3732 3732 3732 3732 3732 3732 3732 3732 3732 3732 3732 3732 3732 3732
      3732 3732 0 0 0 0 3732 3732 3732 3732 3732 3732 0 0 0 0 3732 3732 3732 3732 3732 3732 0 0 0 0 3732 3732 3732 3732 3732 0 0 0 0 3732 3732 3732 3732 3732 3732 0 0 0 0 3732 3732 3732 3732 3732
      3732 3732 0 0 0 0 3732 3732 3732 3732 3732 3732 0 0 0 0 3732 3732 3732 3732 3732 3732 0 0 0 0 3732 3732 3732 3732 3732 0 0 0 0 3732 3732 3732 3732 3732 3732 0 0 0 0 3732 3732 3732 3732 3732
      3732 3732 0 0 0 0 3732 3732 3732 3732 3732 3732 0 0 0 0 3732 3732 3732 3732 3732 3732 0 0 0 0 3732 3732 3732 3732 3732 0 0 0 0 3732 3732 3732 3732 3732 3732 0 0 0 0 3732 3732 3732 3732 3732
      3732 3732 3771 3772 3771 3772 3732 3732 3732 3732 3732 3732 3771 3772 3771 3772 3732 3732 3732 3732 3732 3732 3771 3772 3771 3772 3732 3732 3732 3732 3732 3771 3772 3771 3772 3732 3732 3732 3732 3732 3732 3771 3772 3771 3772 3732 3732 3732 3732 3732
      3732 3732 3732 3732 3732 3732 3732 3732 3732 3732 3732 3732 3732 3732 3732 3732 3732 3732 3732 3732 3732 3732 3732 3732 3732 3732 3732 3732 3732 3732 3732 3732 3732 3732 3732 3732 3732 3732 3732 3732 3732 3732 3732 3732 3732 3732 3732 3732 3732 3732
      3732 3732 3732 3732 3732 3732 3732 3732 3732 3732 3732 3732 3732 3732 3732 3732 3732 3732 3732 3732 3732 3732 3732 3732 3732 3732 3732 3732 3732 3732 3732 3732 3732 3732 3732 3732 3732 3732 3732 3732 3732 3732 3732 3732 3732 3732 3732 3732 3732 3732
      3732 3732 3732 3732 3732 3732 3732 3732 3732 3732 3732 3732 3732 3732 3732 3732 3732 3732 3732 3732 3732 3732 3732 3732 3732 3732 3732 3732 3732 3732 3732 3732 3732 3732 3732 3732 3732 3732 3732 3732 3732 3732 3732 3732 3732 3732 3732 3732 3732 3732
      3732 3732 3732 3732 3732 3732 3732 3732 3732 3732 3732 3732 3732 3732 3732 3732 3732 3732 3732 3732 3732 3732 3732 3732 3732 3732 3732 3732 3732 3732 28 28 28 28 28 28 28 28 28 28 28 28 28 28 28 28 28 28 28 28
      3732 3732 3732 3732 3732 3732 3732 3732 3732 3732 3732 3732 3732 3732 3732 3732 3732 3732 3732 3732 3732 3732 3732 3732 3732 3732 3732 3732 3732 3732 3732 3732 3732 3732 3732 3732 3732 3732 3732 3732 3732 3732 3732 3732 3732 3732 3732 3732 3732 3732
      3732 3732 3732 3732 3732 3732 3732 3732 3732 3732 3732 3732 3732 3732 3732 3732 3732 3732 3732 3732 3732 3732 3732 3732 3732 3732 3732 3732 3732 3732 3732 3732 3732 3732 3732 3732 3732 3732 3732 3732 3732 3732 3732 3732 3732 3732 3732 3732 3732 3732
      3732 3732 3732 3732 3732 3732 3732 3732 3732 3732 3732 3732 3732 3732 3732 3732 3732 3732 3732 3732 3732 3732 3732 3732 3732 3732 3732 3732 3732 3732 3732 3732 3732 3732 3732 3732 3732 3732 3732 3732 3732 3732 3732 3732 3732 3732 3732 3732 3732 3732
      3732 3732 3732 3732 3732 3732 3732 3732 3732 3732 3732 3732 3732 3732 3732 3732 3732 3732 3732 3732 3732 3732 3732 3732 3732 3732 3732 3732 3732 3732 3732 3732 3732 3732 3732 3732 3732 3732 3732 3732 3732 3732 3732 3732 3732 3732 3732 3732 3732 3732
      3732 3732 3732 3732 3732 3732 3732 3732 3732 3732 3732 3732 3732 3732 3732 3732 3732 3732 3732 3732 3732 3732 3732 3732 3732 3732 3732 3732 3732 3732 3732 3732 3732 3732 3732 3732 3732 3732 3732 3732 3732 3732 3732 3732 3732 3732 3732 3732 3732 3732
      3732 3732 3732 3732 3732 3732 3732 3732 3732 3732 3732 3732 3732 3732 3732 3732 3732 3732 3732 3732 3732 3732 3732 3732 3732 3732 3732 3732 3732 3732 3732 3732 3732 3732 3732 3732 3732 3732 3732 3732 3732 3732 3732 3732 3732 3732 3732 3732 3732 3732
      3732 3732 3732 3732 3732 3732 3732 3732 3732 3732 3732 3732 3732 3732 3732 3732 3732 3732 3732 3732 3732 3732 3732 3732 3732 3732 3732 3732 3732 3732 3732 3732 3732 3732 3732 3732 3732 3732 3732 3732 3732 3732 3732 3732 3732 3732 3732 3732 3732 3732
      3732 3732 3732 3732 3732 3732 3732 3732 3732 3732 3732 3732 3732 3732 3732 3732 3732 3732 3732 3732 3732 3732 3732 3732 3732 3732 3732 3732 3732 3732 3732 3732 3732 3732 3732 3732 3732 3732 3732 3732 3732 3732 3732 3732 3732 3732 3732 3732 3732 3732
      3732 3732 3732 3732 3732 3732 3732 3732 3732 3732 3732 3732 3732 3732 3732 3732 3732 3732 3732 3732 3732 3732 3732 3732 3732 3732 3732 3732 3732 3732 3732 3732 3732 3732 3732 3732 3732 3732 3732 3732 3732 3732 3732 3732 3732 3732 3732 3732 3732 3732
      3732 3732 3732 3732 3732 3732 3732 3732 3732 3732 3732 3732 3732 3732 3732 3732 3732 3732 3732 3732 3732 3732 3732 3732 3732 3732 3732 3732 3732 3732 3732 3732 3732 3732 3732 3732 3732 3732 3732 3732 3732 3732 3732 3732 3732 3732 3732 3732 3732 3732
      3732 3732 3732 3732 3732 3732 3732 3732 3732 3732 3732 3732 3732 3732 3732 3732 3732 3732 3732 3732 3732 3732 3732 3732 3732 3732 3732 3732 3732 3732 3732 3732 3732 3732 3732 3732 3732 3732 3732 3732 3732 3732 3732 3732 3732 3732 3732 3732 3732 3732
      3732 3732 3732 3732 3732 3732 3732 3732 3732 3732 3732 3732 3732 3732 3732 3732 3732 3732 3732 3732 3732 3732 3732 3732 3732 3732 3732 3732 3732 3732 3732 3732 3732 3732 3732 3732 3732 3732 3732 3732 3732 3732 3732 3732 3732 3732 3732 3732 3732 3732
      3732 3732 3732 3732 3732 3732 3732 3732 3732 3732 3732 3732 3732 3732 3732 3732 3732 3732 3732 3732 3732 3732 3732 3732 3732 3732 3732 3732 3732 3732 3732 3732 3732 3732 3732 3732 3732 3732 3732 3732 3732 3732 3732 3732 3732 3732 3732 3732 3732 3732
      3732 3732 3732 3732 3732 3732 3732 3732 3732 3732 3732 3732 3732 3732 3732 3732 3732 3732 3732 3732 3732 3732 3732 3732 3732 3732 3732 3732 3732 3732 3732 3732 3732 3732 3732 3732 3732 3732 3732 3732 3732 3732 3732 3732 3732 3732 3732 3732 3732 3732
      3732 3732 3732 3732 3732 3732 3732 3732 3732 3732 3732 3732 3732 3732 3732 3732 3732 3732 3732 3732 3732 3732 3732 3732 3732 3732 3732 3732 3732 3732 3732 3732 3732 3732 3732 3732 3732 3732 3732 3732 3732 3732 3732 3732 3732 3732 3732 3732 3732 3732
      3732 3732 3732 3732 3732 3732 3732 3732 3732 3732 3732 3732 3732 3732 3732 3732 3732 3732 3732 3732 3732 3732 3732 3732 3732 3732 3732 3732 3732 3732 3732 3732 3732 3732 3732 3732 3732 3732 3732 3732 3732 3732 3732 3732 3732 3732 3732 3732 3732 3732
      )
    )
    (tilemap
      (solid #f)
      (z-pos 100)
      (name "Foreground")
      (width 50)
      (height 35)
      (tiles
      0 0 0 0 0 0 0 0 0 0 0 0 0 0 0 0 0 0 0 0 0 0 0 0 0 0 0 0 0 0 0 0 0 0 0 0 0 0 0 0 0 0 0 0 0 0 0 0 0 0
      0 0 0 0 0 0 0 0 0 0 0 0 0 0 0 0 0 0 0 0 0 0 0 0 0 0 0 0 0 0 0 0 0 0 0 0 0 0 0 0 0 0 0 0 0 0 0 0 0 0
      0 0 0 0 0 0 0 0 0 0 0 0 0 0 0 0 0 0 0 0 0 0 0 0 0 0 0 0 0 0 0 0 0 0 0 0 0 0 0 0 0 0 0 0 0 0 0 0 0 0
      0 0 0 0 0 0 0 0 0 0 0 0 0 0 0 0 0 0 0 0 0 0 0 0 0 0 0 0 0 0 0 0 0 0 0 0 0 0 0 0 0 0 0 0 0 0 0 0 0 0
      0 0 0 0 0 0 0 0 0 0 0 0 0 0 0 0 0 0 0 0 0 0 0 0 0 0 0 0 0 0 0 0 0 0 0 0 0 0 0 0 0 0 0 0 0 0 0 0 0 0
      0 0 0 0 0 0 0 0 0 0 0 0 0 0 0 0 0 0 0 0 0 0 0 0 0 0 0 0 0 0 0 0 0 0 0 0 0 0 0 0 0 0 0 0 0 0 0 0 0 0
      0 0 0 0 0 0 0 0 0 0 0 0 0 0 0 0 0 0 0 0 0 0 0 0 0 0 0 0 0 0 0 0 0 0 0 0 0 0 0 0 0 0 0 0 0 0 0 0 0 0
      0 0 0 0 0 0 0 0 0 0 0 0 0 0 0 0 0 0 0 0 0 0 0 0 0 0 0 0 0 0 0 0 0 0 0 0 0 0 0 0 0 0 0 0 0 0 0 0 0 0
      0 0 0 0 0 0 0 0 0 0 0 0 0 0 0 0 0 0 0 0 0 0 0 0 0 0 0 0 0 0 0 0 0 0 0 0 0 0 0 0 0 0 0 0 0 0 0 0 0 0
      0 0 0 0 0 0 0 0 0 0 0 0 0 0 0 0 0 0 0 0 0 0 0 0 0 0 0 0 0 0 0 0 0 0 0 0 0 0 0 0 0 0 0 0 0 0 0 0 0 0
      0 0 0 0 0 0 0 0 0 0 0 0 0 0 0 0 0 0 0 0 0 0 0 0 0 0 0 0 0 0 0 0 0 0 0 0 0 0 0 0 0 0 0 0 0 0 0 0 0 0
      0 0 0 0 0 0 0 0 0 0 0 0 0 0 0 0 0 0 0 0 0 0 0 0 0 0 0 0 0 0 0 0 0 0 0 0 0 0 0 0 0 0 0 0 0 0 0 0 0 0
      0 0 0 0 0 0 0 0 0 0 0 0 0 0 0 0 0 0 0 0 0 0 0 0 0 0 0 0 0 0 0 0 0 0 0 0 0 0 0 0 0 0 0 0 0 0 0 0 0 0
      0 0 0 0 0 0 0 0 0 0 0 0 0 0 0 0 0 0 0 0 0 0 0 0 0 0 0 0 0 0 0 0 0 0 0 0 0 0 0 0 0 0 0 0 0 0 0 0 0 0
      0 0 0 0 0 0 0 0 0 0 0 0 0 0 0 0 0 0 0 0 0 0 0 0 0 0 0 0 0 0 0 0 0 0 0 0 0 0 0 0 0 0 0 0 0 0 0 0 0 0
      0 0 0 0 0 0 0 0 0 0 0 0 0 0 0 0 0 0 0 0 0 0 0 0 0 0 0 0 0 0 0 0 0 0 0 0 0 0 0 0 0 0 0 0 0 0 0 0 0 0
      3771 3772 0 0 0 0 0 0 0 0 0 0 0 0 0 0 0 0 0 0 0 0 0 0 0 0 0 0 0 0 0 0 0 0 0 0 0 0 0 0 0 0 0 0 0 0 0 0 0 0
      3840 3800 3824 0 0 0 0 0 0 0 0 0 0 0 0 0 0 0 0 0 0 0 0 0 0 0 0 0 0 0 0 0 0 0 0 0 0 0 0 0 0 0 0 0 0 0 0 0 0 0
      0 0 0 0 0 0 0 0 0 0 0 0 0 0 0 0 0 0 0 0 0 0 0 0 0 0 0 0 0 0 0 0 0 0 0 0 0 0 0 0 0 0 0 0 0 0 0 0 0 0
      0 0 0 0 0 0 0 0 0 0 0 0 0 0 0 0 0 0 0 0 0 0 0 0 0 0 0 0 0 0 0 0 0 0 0 0 0 0 0 0 0 0 0 0 0 0 0 0 0 0
      0 0 0 0 0 0 0 0 0 0 0 0 0 0 0 0 0 0 0 0 0 0 0 0 0 0 0 0 0 0 0 0 0 0 0 0 0 0 0 0 0 0 0 0 0 0 0 0 0 0
      0 0 0 0 0 0 0 0 0 0 0 0 0 0 0 0 0 0 0 0 0 0 0 0 0 0 0 0 0 0 0 0 0 0 0 0 0 0 0 0 0 0 0 0 0 0 0 0 0 0
      0 0 0 0 0 0 0 0 0 0 0 0 0 0 0 0 0 0 0 0 0 0 0 0 0 0 0 0 0 0 0 0 0 0 0 0 0 0 0 0 0 0 0 0 0 0 0 0 0 0
      0 0 0 0 0 0 0 0 0 0 0 0 0 0 0 0 0 0 0 0 0 0 0 0 0 0 0 0 0 0 0 0 0 0 0 0 0 0 0 0 0 0 0 0 0 0 0 0 0 0
      0 0 0 0 0 0 0 0 0 0 0 0 0 0 0 0 0 0 0 0 0 0 0 0 0 0 0 0 0 0 0 0 0 0 0 0 0 0 0 0 0 0 0 0 0 0 0 0 0 0
      0 0 0 0 0 0 0 0 0 0 0 0 0 0 0 0 0 0 0 0 0 0 0 0 0 0 0 0 0 0 0 0 0 0 0 0 0 0 0 0 0 0 0 0 0 0 0 0 0 0
      0 0 0 0 0 0 0 0 0 0 0 0 0 0 0 0 0 0 0 0 0 0 0 0 0 0 0 0 0 0 0 0 0 0 0 0 0 0 0 0 0 0 0 0 0 0 0 0 0 0
      0 0 0 0 0 0 0 0 0 0 0 0 0 0 0 0 0 0 0 0 0 0 0 0 0 0 0 0 0 0 0 0 0 0 0 0 0 0 0 0 0 0 0 0 0 0 0 0 0 0
      0 0 0 0 0 0 0 0 0 0 0 0 0 0 0 0 0 0 0 0 0 0 0 0 0 0 0 0 0 0 0 0 0 0 0 0 0 0 0 0 0 0 0 0 0 0 0 0 0 0
      0 0 0 0 0 0 0 0 0 0 0 0 0 0 0 0 0 0 0 0 0 0 0 0 0 0 0 0 0 0 0 0 0 0 0 0 0 0 0 0 0 0 0 0 0 0 0 0 0 0
      0 0 0 0 0 0 0 0 0 0 0 0 0 0 0 0 0 0 0 0 0 0 0 0 0 0 0 0 0 0 0 0 0 0 0 0 0 0 0 0 0 0 0 0 0 0 0 0 0 0
      0 0 0 0 0 0 0 0 0 0 0 0 0 0 0 0 0 0 0 0 0 0 0 0 0 0 0 0 0 0 0 0 0 0 0 0 0 0 0 0 0 0 0 0 0 0 0 0 0 0
      0 0 0 0 0 0 0 0 0 0 0 0 0 0 0 0 0 0 0 0 0 0 0 0 0 0 0 0 0 0 0 0 0 0 0 0 0 0 0 0 0 0 0 0 0 0 0 0 0 0
      0 0 0 0 0 0 0 0 0 0 0 0 0 0 0 0 0 0 0 0 0 0 0 0 0 0 0 0 0 0 0 0 0 0 0 0 0 0 0 0 0 0 0 0 0 0 0 0 0 0
      0 0 0 0 0 0 0 0 0 0 0 0 0 0 0 0 0 0 0 0 0 0 0 0 0 0 0 0 0 0 0 0 0 0 0 0 0 0 0 0 0 0 0 0 0 0 0 0 0 0
      )
    )
  )
)
