(supertux-level
  (version 2)
  (name (_ "Rescue Girlies"))
  (author "R. Bassett Jr.")
  (contact "http://www.tpot.ca")
  (license "non-redistributable")
  (sector
    (name "main")
    (music "music/garden.music")
    (ambient-light 1 1 1)
    (sprite-change
      (change-on-touch #f)
      (initial-stay-action #f)
      (x 0)
      (y 5)
      (sprite "images/worldmap/common/tux.sprite")
    )
    (sprite-change
      (change-on-touch #f)
      (initial-stay-action #f)
      (x -1)
      (y 6)
      (sprite "images/worldmap/common/boat/boat.sprite")
    )
    (sprite-change
      (change-on-touch #f)
      (initial-stay-action #f)
      (x 4)
      (y 14)
      (sprite "images/worldmap/common/tux.sprite")
    )
    (sprite-change
      (change-on-touch #f)
      (initial-stay-action #f)
      (x 4)
      (y 16)
      (sprite "images/worldmap/common/boat/boat.sprite")
    )
    (teleporter
      (automatic #t)
      (x 1)
      (y 5)
    )
    (teleporter
      (worldmap "levels/bonus/fair.stwm")
      (spawnpoint "main")
      (message (_ "The Midforest Fair (Bonus Levels!)"))
      (x 14)
      (y 13)
      (sprite "images/worldmap/common/fair.sprite")
    )
    (tilemap
      (solid #t)
      (z-pos 1)
      (name "main")
      (width 26)
      (height 19)
      (tiles
      27 19 58 23 12 9 808 790 565 566 790 685 686 608 609 610 611 615 652 9 9 9 9 649 610 611
      28 19 59 19 17 9 808 790 574 575 790 687 1917 617 618 619 620 1917 652 9 9 9 9 649 619 620
      66 40 44 914 73 74 406 405 583 584 685 686 1917 1917 1917 1917 1917 1917 614 656 9 9 9 649 1842 1842
      21 60 20 18 13 9 808 404 406 406 700 701 762 762 762 762 762 761 1917 614 655 656 9 631 632 1842
      14 18 13 9 9 9 808 410 410 410 705 706 814 420 420 420 1917 765 1917 1917 1917 652 9 9 631 632
      80 78 9 9 9 9 808 410 410 410 410 707 814 420 420 420 1917 765 1917 615 594 642 9 9 9 649
      79 9 9 9 9 9 808 789 871 872 790 874 875 876 877 420 1917 765 1917 652 9 9 9 9 9 649
      84 78 81 794 804 804 410 410 880 881 882 883 884 885 886 887 1917 765 1917 652 9 9 9 655 655 633
      9 9 79 791 402 406 406 406 405 890 891 892 893 894 895 896 410 717 711 614 9 9 605 1917 1917 1917
      795 9 79 791 409 789 789 790 409 899 900 901 902 903 904 905 410 410 717 711 642 631 632 1917 1917 1917
      807 9 79 791 409 789 789 790 409 907 908 909 910 911 912 789 790 789 420 409 9 9 1884 420 420 420
      793 80 85 791 409 789 789 790 404 406 408 873 789 789 789 789 402 406 407 413 9 9 791 809 801 801
      80 85 9 791 409 789 789 790 790 790 409 790 789 410 402 406 413 789 409 807 9 9 792 793 651 651
      79 9 9 791 409 789 410 410 790 790 409 790 789 789 411 789 789 789 409 807 651 651 651 651 651 651
      79 9 9 808 409 410 410 410 790 790 409 790 789 789 789 789 789 789 409 807 651 651 417 651 651 651
      79 9 9 792 767 801 801 818 790 790 404 406 406 406 406 406 406 406 413 793 651 651 651 651 651 651
      79 9 9 9 79 9 9 791 790 790 789 790 789 790 789 790 789 809 793 651 651 651 651 651 651 651
      84 78 78 78 85 9 9 792 801 801 801 801 801 801 801 801 801 793 651 651 651 651 651 651 651 651
      651 651 651 651 651 651 651 651 651 651 651 651 651 651 651 651 651 651 651 651 651 651 651 651 651 651
      )
    )
    (tilemap
      (solid #f)
      (z-pos 2)
      (name "TreeBottom")
      (width 26)
      (height 19)
      (tiles
      0 0 0 829 0 0 0 0 0 0 0 0 820 0 0 0 0 829 0 0 0 0 0 0 0 0
      0 0 0 0 0 0 0 0 0 0 0 0 829 0 820 0 820 0 0 0 0 0 0 0 0 820
      0 0 0 0 0 0 850 0 0 0 0 0 847 848 829 0 829 0 820 0 820 0 0 0 820 829
      0 0 832 0 0 0 850 0 0 0 0 0 0 0 0 0 0 0 829 820 829 819 0 0 829 819
      0 0 0 0 0 850 843 844 0 819 0 0 865 866 867 868 0 0 0 829 0 828 0 0 0 828
      0 0 0 0 0 0 852 853 0 828 0 819 0 0 0 868 819 0 0 0 0 0 0 0 0 0
      0 0 0 0 0 0 861 862 0 0 0 828 0 0 0 868 828 0 0 0 0 0 843 844 0 0
      0 0 0 0 0 0 0 0 0 0 0 0 0 0 0 852 819 0 0 0 0 0 852 853 0 0
      819 0 0 0 0 0 0 0 0 0 0 0 0 0 0 0 828 0 0 1927 1928 1928 861 862 843 844
      828 0 0 0 0 0 819 0 0 1927 1928 1929 0 0 0 819 0 0 0 0 0 0 0 819 852 853
      820 0 0 0 0 819 828 0 0 1930 1931 1932 843 844 0 828 0 0 0 0 0 0 0 828 861 862
      0 0 0 0 0 828 819 0 0 1933 1934 1935 852 853 0 0 0 0 0 0 0 0 0 0 0 0
      0 0 0 0 0 819 828 0 0 0 0 819 861 862 0 0 843 844 0 0 0 0 0 0 0 0
      0 0 0 0 0 828 819 0 0 0 0 828 0 0 0 0 852 853 0 0 0 0 0 0 0 0
      0 0 0 0 0 0 828 819 0 819 0 0 0 0 0 0 861 862 0 0 0 0 0 0 0 0
      0 0 0 0 0 0 0 828 819 828 0 0 0 0 0 0 0 0 0 0 0 0 0 0 0 0
      0 0 0 0 0 0 0 0 828 0 0 0 0 0 0 0 0 0 0 0 0 0 0 0 0 0
      0 0 0 0 0 0 0 0 0 0 0 0 0 0 0 0 0 0 0 0 0 0 0 0 0 0
      0 0 0 0 0 0 0 0 0 0 0 0 0 0 0 0 0 0 0 0 0 0 0 0 0 0
      )
    )
    (tilemap
      (solid #f)
      (z-pos 100)
      (name "TreeTop")
      (width 26)
      (height 19)
      (tiles
      0 0 0 0 0 0 0 0 0 0 0 0 0 0 0 0 0 0 0 0 0 0 0 0 0 0
      0 0 0 0 0 0 0 0 0 0 0 0 0 0 0 0 0 0 0 0 0 0 0 0 0 0
      0 0 0 0 0 0 819 0 0 0 819 0 0 848 849 850 851 0 0 0 0 0 0 0 0 0
      0 0 0 0 0 0 828 0 819 0 828 855 856 857 858 859 860 0 0 843 844 0 0 0 0 0
      0 0 0 0 0 0 0 0 828 843 844 0 843 844 843 844 869 0 819 852 853 0 0 0 0 0
      0 0 0 0 0 0 0 843 844 852 853 0 852 853 852 853 0 0 828 861 862 0 0 0 0 0
      0 0 0 0 0 0 820 852 853 861 862 0 861 862 861 862 0 0 843 844 0 0 0 0 819 0
      0 0 0 0 0 0 829 861 862 0 0 0 0 0 0 0 843 844 852 853 0 0 0 819 828 0
      0 0 0 0 0 819 0 843 844 0 0 0 0 0 0 0 852 853 861 862 0 0 1929 828 0 0
      0 0 0 0 0 828 844 852 853 0 0 0 820 843 844 0 861 862 819 0 0 0 843 844 0 820
      0 0 0 843 844 852 853 861 862 0 0 0 829 852 853 0 820 0 828 0 0 0 852 853 0 829
      0 0 0 852 853 861 862 0 0 0 0 0 0 861 862 0 0 820 0 0 0 0 861 862 0 0
      0 0 0 861 862 0 843 844 0 820 843 844 0 819 0 820 0 829 0 0 0 0 0 0 0 0
      0 0 0 0 0 820 852 853 0 829 852 853 0 828 0 0 820 0 0 819 0 0 0 0 0 0
      0 0 0 0 0 0 861 862 843 844 861 862 843 844 0 820 0 0 0 828 0 0 0 0 0 0
      0 0 0 0 0 0 0 0 852 853 0 0 852 853 820 0 0 819 0 0 0 0 0 0 0 0
      0 0 0 0 0 0 0 0 861 862 0 0 861 862 829 0 0 828 0 0 0 0 0 0 0 0
      0 0 0 0 0 0 0 0 0 0 0 0 0 0 0 0 0 0 0 0 0 0 0 0 0 0
      0 0 0 0 0 0 0 0 0 0 0 0 0 0 0 0 0 0 0 0 0 0 0 0 0 0
      )
    )
    (level
      (name "1-level.stl")
      (x 2)
      (y 2)
    )
    (level
      (name "2-level.stl")
      (x 9)
      (y 3)
    )
    (level
      (name "3-level.stl")
      (x 17)
      (y 4)
    )
    (level
      (name "4-level.stl")
      (x 19)
      (y 9)
    )
    (level
      (name "5-level.stl")
      (x 19)
      (y 11)
    )
    (level
      (name "6-level.stl")
      (x 18)
      (y 15)
    )
    (level
      (name "7-level.stl")
      (x 11)
      (y 15)
    )
    (level
      (name "8-level.stl")
      (x 10)
      (y 11)
    )
    (level
      (name "9-level.stl")
      (x 4)
      (y 8)
    )
    (level
      (name "story-1.stl")
      (x 0)
      (y 2)
      (sprite "images/worldmap/common/storydot.sprite")
    )
    (level
      (name "story-2.stl")
      (x 18)
      (y 13)
      (sprite "images/worldmap/common/storydot.sprite")
    )
    (level
      (name "story-3.stl")
      (x 4)
      (y 13)
      (sprite "images/worldmap/common/storydot.sprite")
    )
    (worldmap-spawnpoint
      (name "main")
      (x 0)
      (y 2)
    )
    (worldmap-spawnpoint
      (name "fairgrounds")
      (x 14)
      (y 13)
    )
  )
  (tileset "images/worldmap.strf")
)
